  #########
###  #    #
#   *.* # #
# * *@* # #
# # .*. # #
#  $ $ $  #
##  #######
 ####
Author: GRIGoRusha
Title: Colobok #103
Comment:
color yellow
Comment-End:
