 ####
 #  ###
##    #
#  $  #
# $$$###
## $   ###
 # ##$   #
##  #    #
#   ### ####
# # #....  #
#    .# .# ###
### #@ ..    #
  #  ....# # #
  #### ###   #
    #    #  ##
    #   $## #
    ###   $ ##
      ###$$$ #
       #  $  #
       #    ##
       ###  #
         ####
Author: GRIGoRusha
Title: Rebus #40
Comment:
color blue
Comment-End:
