 #### #########
 #  ###       #
## $ $  # ### #
#   $ ###. .  #
# #$$ ##. . # #
#    $#. .  # #
# $#  $ .#.   #
#  $  #.   .###
# $###### @##
#  #    ####
####
Author: GRIGoRusha
Title: Zontik #09
Comment:
color yellow
Comment-End:
