 #########
 #   ##  #
 #       #
 ##$# #$$##
 #...*....#
## #$#$#  #
#  $   $ ##
#   #@  ##
#########
Author: GRIGoRusha
Title: Nitka #30
Comment:
color blue
Comment-End:
