    ####
#####  # 
# $ $ $# 
#  ... #  
#  .#. #  
##$*.*$##
#  # .$ #
#  . #$@#
#  #  $ #
####  ###
   ####
Author: GRIGoRusha
Title: Miasorubka (#07r) #20
Comment:
color blue
Comment-End:
