      #####
#### ##   ###
#  ###  #$@ #
#...     $$ #
#. .## # #  #
#...#  $$#$##
##  $$#     #
 ###    #   #
   ###  #####
     ####
Author: GRIGoRusha
Title: Okno #41
Comment:
color purple
Comment-End:
