 #####
 #   ##
 # #  #
## *$ ##
# .$.$ #
#  .$.$##
#  #.$.@#
## $ *$.#
 ### #. #
   #   ##
   #####
Author: GRIGoRusha
Title: Resheto #51
Comment:
color green
Comment-End:
