########
#  #@  #
#  $   ####
# $#.##   #
##  ... # #
 # ##.. $ #
##$##.#$# #
#  $  $   #
#   #######
#####
Author: GRIGoRusha
Title: Oberon #136
Comment:
color green
Comment-End:
