   #####
  ##   #########
  #       ##   ##
 ## #$#...$ $#  #
##     #*#.#. $ #
#  #$$$#+#***#  #
# $  # #*#. .  ##
#  #$ $...#$# ##
##   ##       #
 #########   ##
         #####
Author: GRIGoRusha
Title: Father diode #110
Comment:
color red
for David Holland
Comment-End:
