########  
#   #  ##
#   $   #
## ##..$#
 #@## . #
 # . ##$#
 #$ .## ##
 #   $   #
 ##  #   #
  ########
Author: GRIGoRusha
Title: Kompas #69
Comment:
color red
Comment-End:
