   ####
   #  #
####. ####
#   .    ###
# .$.$$*.* #
###  $@$   #
  ####$.####
     #  #
     ####
Author: GRIGoRusha
Title: My heart #113
Comment:
color red
thank Serg Belyaev
Comment-End:
