###################
#  .   . #        #
#.#$##$# # #$##$# #
#$  ## $  $ .##. .#
#.#$  .# # #  $ # #
#   ##   #  .##. .#
# #$##$##### ## # #
#     .  #@$  . $ #
#     .  # $  . $ #
# #$##$##### ## # #
#   ##   #  .##. .#
#.#$  .# # #  $ # #
#$  ## $  $ .##.#.#
#.#$##$# # #$##$# #
#  .   . #        #
###################
Author: GRIGoRusha
Title: Bardak #01
Comment:
color purple
Comment-End:
