       ####
  ######  # 
  #  #.. $# 
###  #..$ # 
# $ $ .# $###
#  $ #+ $ $ #
### $..#    #
  #$ ..#  ###
  #  ######  
  ####       
Author: GRIGoRusha
Title: Perekrestok #129
Comment:
color purple
Comment-End:
