     ####
######  #
#   #..$#
#  $$.. #
##   *.$##
 ###$.*  ##
  #  ..$$ #
  # $ #  @#
  #  ######
  ####
Author: GRIGoRusha
Title: Babochka #90
Comment:
color green
Comment-End:
