##### #####
#   ###   #
#  $   $  #
## #...# ##
 # $***$ ##
 ## ...#  #
  #@ #$$  #
  ##   ####
   #####
Author: GRIGoRusha
Title: Rogalik #134
Comment:
color yellow
Comment-End:
