  #######
  #  #  ###
###.$.$. @#
#  . #$.$ #
# #$ .$. ##
#  . $$ ##
###  #  #
  #######
Author: GRIGoRusha
Title: Zavhoz #24
Comment:
color blue
Comment-End:
