   #####
  ##   ###
 ##  #   #
 #   $$# #
 #$.#    #
##..*$# ##
# .#*   #
#  . #$@#
####   ##
   #####
Author: GRIGoRusha
Title: Metro #67
Comment:
color yellow
Comment-End:
