#####     
#   ##    
#  $ #    
## $.#####
 # $.@#  #
 ##$*$   #
  # ...  #
  #  #  ##
  ####### 
Author: GRIGoRusha
Title: LoLa (#93r) #89
Comment:
color green
Comment-End:
