           #####
    ##### ##   #
    #   ### $  #
    #       $ ##
###### ### #$##
#   #..... # ###
#@# $.###.$#   #
#   #.###.$  # #
### #....$##   #
 ## $ $   ######
##  ####$##
# $$    $ #
#   ###   #
#  ## #####
####
Author: GRIGoRusha
Title: Nadejda #131
Comment:
color blue
Comment-End:
