  #####
 ##   #
 #    #####
##$# ##   #
#@ # $    #
# $.*.* ###
#  $.*. #
##  # * #
 #####  #
     ####
Author: GRIGoRusha
Title: for Paul #130
Comment:
color red
Comment-End:
