   #####
####   ###
# @** .. #
# $    # #
# $ #### #
###      #
  ########
Author: GRIGoRusha
Title: Ustal #88
Comment:
color purple
Comment-End:
