########
#  #   ###
#   .$.  #
#  ##@## #
## $.$.  #
#  #   # #
#  $*#.$ #
####   ###
   #####
Author: GRIGoRusha
Title: Rostok #43
Comment:
color purple
Comment-End:
