     ########
  ####      #####
  #  $ ## $ $ $@#
  # ##.##*#$ $ $#
### ......#  $$ ##
#   ......#  #   #
# #$......#$  $  #
# # .......$$# $ #
# $$###.###$  $ ##
###  $  $  $  $ #
  #   $ $  $  $ #
  ######   ######
       #####
Title: Original conversion (42) #02
Author: GRIGoRusha
Comment:
color green
Comment-End:
