 ########
 #   #@ #
 # *.$ $##
###*.# $ #
# $ $.*  #
#   #..###
##      #
 ####   #
    #####
Author: GRIGoRusha
Title: Kubiki #36
Comment:
color yellow
Comment-End:
