  ########
 ## @    #
## ...## #
#  *.*   #
# #***$ ##
# $ $ ###
##  #  #
 #  $  #
 ####  #
    ####
Author: GRIGoRusha
Title: CFL #80
Comment:
color blue
Comment-End:
