       #####
########   #
#  #       #
#    $ ## ##
#  ###### #
##$####.. ###
#  # ..$*$  #
#    *@ . # #
#  #$* #### #
#### ###### #
   #        #
   ##########
Author: GRIGoRusha
Title: Krik #87
Comment:
color blue
Comment-End:
