  ###### 
### @. # 
# . $# ##
# $ . $ #
## # $. #
 # .$ ###
 ##  ##  
  ####   
Author: GRIGoRusha
Title: Strelka #25
Comment:
color aqua
Comment-End:
