     #####
######   ##
#    $ $  #
# # ###$#@#
#   #  $  ##
##.... #$$ #
 # #.### # #
 #  .      #
 ##   ######
  #####
Author: GRIGoRusha
Title: Return #107
Comment:
color yellow
Comment-End:
