    ####
#####  #
#      #
#@$.*.$#
#  *#* #
## .*.$##
#  # *  #
# $. #$ #
#  #    #
####  ###
   ####
Author: GRIGoRusha
Title: The disorder #07
Comment:
color green
Comment-End:
