#####
#   #####
# # ##  #
# $    $##
### ..#  #
  #$...  #
### @..# #
# $  $ $ #
# # ###$ #
#   # #  #
##### ####
Author: GRIGoRusha
Title: Verenica #14
Comment:
color aqua
Comment-End:
