  #######
  #  #  ###
### $# .  #
#  $.$.   #
#  .$.$.###
## $.$.$#
 # .$.$@#
 ###.$### 
   #  #   
   ####   
Author: GRIGoRusha
Title: Marazm #122
Comment:
color green
Comment-End:
