  ####
###  ####
#  $  $ #
#  #.#$ #
# ..*..@#
## #.#$##
#  $  $ #
#   #   #
#########
Author: GRIGoRusha
Title: Burlak #26
Comment:
color red
Comment-End:
