   #######   
 ###  .  ####
## $ #.# $  #
# $ $#.#$ $ #
#  $.. ..$  #
### ##@## ###
  #   .   #  
  #########  
Author: GRIGoRusha
Title: Chmoki #23
Comment:
color blue
Comment-End:
