    ####
   ##  ###
####     #
#  #*.*# #
#   .#.# #
#  #*.*  #
##   # $##
 #  $@# ##
 ## #$#  #
 #    $  #
 #   ##  #
 #########
Author: GRIGoRusha
Title: Dreams #117
Comment:
color purple
Comment-End:
