       ####
   #####  #
   #   #  #
   #  $ $ #
 ### #$   ####
 # $ $ ##$   #
 #  # $@$ # $#
 #  #  $   $ #
 ## ####*##  ####
 # $#.....#     #
 #  *...*..$# $ #
## $#.....#   ###
#   ###.#.#####
# $$  #  ##
#  #     #
######   #
     #####
Title: Original conversion (15) #84
Author: GRIGoRusha
Comment:
color red
Comment-End:
