    #####
#####   #####
#   # #$#   #
# #  ...  # #
# $ #.#*# $ #
###$###.. ###
 #    $    #
 # #@###$# #
 #   # #   #
 ##### #####
Author: GRIGoRusha
Title: Sheriff #116
Comment:
color blue
Comment-End:
