#########
#  ##   #
#  $    ###
#  ##$ #  #
## #   $$@#
 # *. ##  #
 # #.###$##
 #$#*##   #
 # ..#    #
 ##..    ##
  #  #####
  ####
Author: GRIGoRusha
Title: KUB #123
Comment:
color purple
Comment-End:
