 #####
 #   ###
 #  $  #
### *  #
#  * *###
# # *   #
# #*@*# #
#   * # #
###*.*  #
 #  * ###
 #     #
 ###   #
   #####
Author: GRIGoRusha
Title: Cheburek #12
Comment:
color green
Comment-End:
