 #####
 #   ######
 #  $ #   #
 #..*.$   #
## #$*@#$##
#   $.$# # 
#   #..  # 
#####  ### 
    ####   
Author: GRIGoRusha
Title: Povorot #29
Comment:
color yellow
Comment-End:
