       ####
##### ##  #
#   ###   #
#  $@$    #
## $#$#  ##
 # ...# ###
 # #**#$$ #
 # ...  # #
 ##   #   #
  #########
Author: GRIGoRusha
Title: Svadba #125
Comment:
color red
Comment-End:
