 #####
 #   ####
 # .@.  #
###.$#  #
# $.$.$##
#  .#. ##
##$ $ $ #
 #  #   # 
 ########
Author: GRIGoRusha
Title: Raketa #37
Comment:
color red
Comment-End:
