#####
#   #
#$ $#
#.. ####
# *  $ #
# ..** #
#  $$. #
#### ..#
   #$ $#
   # @ #
   #####
Author: GRIGoRusha
Title: Snake #38
Comment:
color green
Comment-End:
