    ####
#####  #
#   #$ #
#      ##
##$###  #
 #  ... #
##$# .###
#  ##@##
#  $   #
#  #   #
########
Author: GRIGoRusha
Title: Telefon #75
Comment:
color green
Comment-End:
