   #####
  ##   #########
  #       ##   ##
 ## #$#...$ $#  #
##    .#$#.#. $ #
#  #$$*#+#*$*#  #
# $  #.#$#. .  ##
#  #$ $...#$# ##
##   ##       #
 #########   ##
         #####
Author: GRIGoRusha
Title: Ziko-City #127
Comment:
color purple
Comment-End:
