####
#  ### #####
#  $ ###   #
#  $ $@$   #
##$# ...#$##
## ##.#.  ##
#     # #  #
#   #.*.$  #
#########  #
        ####
Author: GRIGoRusha
Title: Mad Dog #139
Comment:
color purple
Comment-End:
