 ########
 #  #   ###
##  $     #
#   ##$#  #
# $ #..# ##
###$#..# #
  #@$..  #
  #$# #  #
  #   ####
  #####
Author: GRIGoRusha
Title: Wake up #102
Comment:
color blue
Comment-End:
