    ####
 ####. ##
##      #
#  $#$  #
#. $..# ##
## #..$ .#
 # $$#$  #
 #   @$ ##
 ## .####
  ####
Author: GRIGoRusha
Title: Zapiataya #74
Comment:
color green
Comment-End:
