 #########
##   #   #
# . . $  #
# #*.* $##
# $ #.*  #
#  $@*#. #
####$ *  #
   #   ###
   #####
Author: GRIGoRusha
Title: Shito-Krito #86
Comment:
color green
Comment-End:
