####
#@ ########
#  *  #   #
#.**$     #
#   ### *.#
#   #  $*$#
#####   . #
    ####  #
       ####
Author: GRIGoRusha
Title: Minutka #98
Comment:
color blue
Comment-End:
