  #####  
 ##   ## 
##  #  ##
## .$. ##
# $$.$$ #
# .$$$. #
## .+. ##
 ####### 
Author: GRIGoRusha
Title: Derji Morda #57
Comment:
color red
Comment-End:
