#####
#   #######
# $    #  #
##$#   $$ #
#  ##.##  #
# $$...  ##
#  #...#@#
# #### #$#
#        #
##########
Author: GRIGoRusha
Title: Tamagochi #82
Comment:
color red
Comment-End:
