 ####
 #  #
##  #######
#  .$ #   #
# .$* # $ #
##$* . . ##
 #  # *$* #
 # @## .  #
 ####   ###
    #   #
    #####
Author: GRIGoRusha
Title: Domovoy #96
Comment:
color green
Comment-End:
