#####
#   ######### 
# $         ##
##$### # $...#
 # $   ## $ .#
## # ..#  $#.#
#..##.##  $  #
#.  $  ## $###
#  # $$@#  #  
#####   ####  
    #####     
Author: GRIGoRusha
Title: Juravli #140
Comment:
color green
Comment-End:
