####   #####
#  ## ##   #
#   ### $  #
# $$    $ ##
##  ####$##
 ##   . $ #
  # # ... #
 ##$##**###
 # $ ...#
 #   ##+#
 ########
Author: GRIGoRusha
Title: Pryanik #124
Comment:
color yellow
Comment-End:
