   #######
 ###  #  #
 #  $@   #
 # #  #..#
 # $$##..#
####  .**#
#   $$.# ##
#   # ##  #
####   $  #
   #   #  #
   ########
Author: GRIGoRusha
Title: Uspex #128
Comment:
color green
Comment-End:
