##########
#   ##   #
#   $    #
##.#*## ##
# ..* @ ##
# *** #  #
###.# #  #
 #  #$$  #
 #  $  ###
 #  #  #
 #######
Author: GRIGoRusha
Title: Serpik #112
Comment:
color blue
Comment-End:
