#######
#  @  #
# .*  #
# $*$##
## *  #
 # *  #
##$.$##
#  *  #
# .#. #
#  #  #
#######
Author: GRIGoRusha
Title: Rassvet #47
Comment:
color purple
Comment-End:
