#######
#...  ###
# ##    #
#  $  $ #
#.#$##$##
#   #@ #
###   ## 
  #####
Author: GRIGoRusha
Title: Lastochki (#08r) #44
Comment:
color purple
Comment-End:
