    #####
 ####   ###
##  $ $   ##
#  ### ##  #
# #  $   # #
# ...*.... #
# # $ $  # #
#  ## ###  #
## $   $  ##
 ### @ ####
   #####
Author: GRIGoRusha
Title: The X #53
Comment:
color green
Comment-End:
