######
#   .#####
# # .    #
# # .#$# #
#.  .# $ #
## #.@ # #
 # $ # $ #
 ###  $$ #
   ##   ##
    ######
Author: GRIGoRusha
Title: One left #60
Comment:
color yellow
Comment-End:
