 #########
## .     #
# .*.$ $ #
#...### ##
#.. $@$  #
#.# $$$$ #
# ### $  #
#     ####
#######   
Author: GRIGoRusha
Title: Korona
Comment:
date: 27.06.06
Comment-End:
