    #####
    #   ##
#####$   #
# $ $ $  #
# .$ $@# #
##..$ ## #
##.# $   #
# ..#$ ###
# ...$.#
########
Author: GRIGoRusha
Title: The Drift
