   #####
####   #
#  @ *$#
#  * * ##
## ***  #
 # .*   #
 ###   ##
   #####
Author: GRIGoRusha
Title: Antenna
Comment:
date: 25.09.05
Comment-End:
