    #####
 ####.  #
 #  .*  #
 #  #+ ##
 #$$**.#
 #   $ #
## ### ##
#    $  #
#   #   #
#########
Author: GRIGoRusha
Title: First Goal
Comment:
date: 15.01.06
Comment-End:
