  #####
  # . #
  # . ##
 ##$.$ #
 # .*..#
## $#$ #
# $ @ $#
#   #  #
########
Author: GRIGoRusha
Title: Space rocket
Comment:
date: 19.09.05
Comment-End:
