 ########
##  ..* #
#  #... #
# # .#.##
# #   $##
#  $  $ #
## $##$ #
 #$   $ #
 #   #@ #
 ########
Author: GRIGoRusha
Title: Whirlwind
Comment:
date: 24.06.06
Comment-End:
