  ####
###  #
#  * ###
# $*$  #
#. * . #
#  # ###
## # #
 # @ #
 #####
Author: Dries De Clercq and GRIGoRusha
Title: Cros life
Comment:
date: 24.06.06
Comment-End:
