   ####
   #  #
####. ###
#  $$$@ #
#  .. # #
##$$$   #
 #...####
 ##  #
  ####
Author: GRIGoRusha
Title: Light Draft
Comment:
for Monry
Comment-End:
