#####
#   ####
#  $.$ ##
##$#@#  #
 # ...  #
##$#.# ##
#   $   #
#   #   #
#########
Author: Aymeric du Peloux and GRIGoRusha
Title: Hybrid
Comment:
remodel NaboKosmos 32
Comment-End:
