    ####
#####  ####
# $ $ $   #
# ..  #   #
##.. $#####
 #.. $   #
 #.#$#$$@#
 #.  #   #
 #########
Author: GRIGoRusha
Title: Open Air
