    ####
    #  ###
##### $$ #
# $ $  $ #
# #.# #$ #
#  .  #@ #
###.  $$ #
 # .###  #
 # .... ##
 ########
Author: GRIGoRusha
Title: Big L
Comment:
date: 09.10.05
Comment-End:
