  ######
###    #
#   ## ####
# # $@$   #
# #$...$# #
# # *** # #
#  $...$# #
##  ##    #
 #####  ###
     ####
Author: GRIGoRusha
Title: Opened Heart
