   ####
  ##@ ###
  # * . ##
### * *$ #
#   **.  #
#    $# ##
#####   #
    #####
Author: GRIGoRusha
Title: To dock
Comment:
date: 21.09.05
Comment-End:
