  #####
 ##   #
 #  # ##
##*.   #
# *.#  #
#@#*$  #
# *. # #
##$# # ##
# $     #
#   #   #
#########
Author: GRIGoRusha
Title: Kiborg
Comment:
for Fred, with many Thanks for You
Comment-End:
