#########
#   #####
# #     #
# #     #
#***## ##
# *. #$##
# *#  $ #
#.*.  $ #
# @#    #
#########
Author: GRIGoRusha
Title: Tonus
Comment:
date: 08.01.06
Comment-End:
