 ########
 #  *   #
 #@ * * #
##$$*$* #
# $ * . #
# # . ###
# . . #
#######
Author: YASGen, Brian Damgaard and GRIGoRusha
Title: Impossible Way
Comment:
for Brian Damgaard
design some level from YASGen level set
Comment-End:
