 ######
 #  + ####
##  #    #
# ** *** #
#   $   ##
####  ###
   #  #
   ####
Author: GRIGoRusha
Title: Sunrise
Comment:
date: 22.09.05
Comment-End:
