  #######
### .$  #
#@$$..  #
# $..#  #
# $$.$ ##
# $..  # 
######## 
Author: GRIGoRusha
Title: Northern lights
Comment:
date: 16.04.05
Comment-End:
