    ####
#####  ##
#    .. #
#   #.# #
## # ** #
 # # ..###
## #$$$  #
#   $@$  #
#   ######
#####
Author: GRIGoRusha
Title: Good House
Comment:
date: 25.01.08
Comment-End:
