#########
#   #   #
#   $   #
## #$# ##
## # . #
#..*+*$#
#  $#  #
###    #
  ######
Author: GRIGoRusha
Title: Star forces
Comment:
date: 18.09.05
Comment-End:
