####
#  ######
#   # . #
# $$ $$@#
##.....##
 # $ $ #
 #  ####
 ####
Author: Dries De Clercq and GRIGoRusha
Title: Formatur Una
Comment:
date: 25.06.06
Comment-End:
