 #######
 #  #@ #
 #  $**#
 #  #..#
## $$*.##
#   #. .#
# $ $   #
##   ####
 #####
Author: GRIGoRusha
Title: The Third Heaven
Comment:
date: 31.01.08
Comment-End:
