#####
#   #####
#    $  #
## #..  #
#  .*#$ ##
# # *+$  #
#  $.* $ #
##  ######
 ####
Author: GRIGoRusha
Title: The Flame
Comment:
date: 01.07.06
Comment-End:
