 ######
 #.   ###
##*## $ #
# *   @ #
# .*#$  #
##    ###
 #  ###
 ####
Author: GRIGoRusha
Title: Milky Way
Comment:
date: 18.09.05
Comment-End:
