 #########
 #  *.#  #
 #$...** #
 # .#.#. #
## #     #
#  $ #   #
#@$$$$ ###
#  $ # #
####   #
   #####
Author: GRIGoRusha
Title: Two Life
Comment:
date: 03.01.06
Comment-End:
