 ########
 # @##  #
 # $##$ #
 # $    #
##$##$# #
#  $  # #
#  #.   #
## ...#*#
 ##. .  #
  #######
Author: GRIGoRusha
Title: Up-Down
Comment:
date: 31.07.06
Comment-End:
