 ####
##  ###
#  *$ ###
#  *@*  #
#  ***. #
#  *    #
## *  ###
 ######
Author: GRIGoRusha
Title: Peace
Comment:
date: 25.10.05
Comment-End:
