   #####
  ###  #
  #   $##
 ## # $ ##
 #....#. #
 # #$**..#
##  $@$  #
#  $###$##
#       #
#  ######
####
Author: GRIGoRusha
Title: Tramplin
Comment:
date: 14.01.06
Comment-End:
