  ####
  #  ##
  #   ###
  #  *@ #
### **$ #
#  **  ##
#  *  ##
### . #
  #####
Author: Dries De Clercq and GRIGoRusha
Title: Non Alter
Comment:
date: 24.06.06
Comment-End:
