   #####
 ###   ##
 #      #
 # #..# ##
 #$#****.#
 #       #
## #### ##
#@$$     #
#   ##   #
##########
Author: Nakamiya and GRIGoRusha
Title: Lost Hunter
Comment:
for Nakamiya
Comment-End:
