  ########
  #. ##  #
  #...   #
 ## .##  #
 # $.$ $##
## ##$#@ #
#    $ $ #
#     #  #
##########
Author: GRIGoRusha
Title: The cluster
Comment:
date: 22.06.06
Comment-End:
