  #####
  # + #
### * #
#   * #
#  $*$###
### .   #
  #$.$. #
  #   ###
  #####
Author: GRIGoRusha
Title: The Candle
