    ####
    #  #
#####  ###
#   *$   #
#   *. * #
#@***  ###
###  ###
  #  #
  ####
Author: Dries De Clercq and GRIGoRusha
Title: FemtoCosmos
Comment:
date: 29.06.06
Comment-End:
