    #####
#####   ##
#  #   $ #
#  # $$$ #
#$$   #  #
#.* ##. ##
#@*.... #
######  #
     ####
Author: GRIGoRusha
Title: Toporiki
Comment:
date: 19.06.06
Comment-End:
