   ######
 ### . .#
 #@$ .#.#
##$#$...#
#  $ ##.##
# #   $  #
#  $ $ $ #
#   ######
#####
Author: GRIGoRusha
Title: Four
Comment:
date: 06.07.06
Comment-End: