######
#    #####
# ##$$ $@#
# #   $  #
#...#$ $ #
## .  #  #
 #..  $ ##
 #.##$###
 #.   #
 ######
Author: GRIGoRusha
Title: Query Mark
