  ####
 ##  ####
 # * #  #
## .* * #
#  *.* @#
#   $ $##
####   #
   #####
Author: GRIGoRusha
Title: Scruple
Comment:
date: 08.07.06
Comment-End:
