  ####
### @####
# $$    #
#  $ #$$##
#  ##  $ #
## #   $ #
# ...*#  #
# ....  ##
#########
Author: GRIGoRusha
Title: Tort
Comment:
date: 12.01.06
Comment-End:
