  #####
  #   ###
  # .$. #
###$.$@ #
# . .$###
#  $. #
## ##$#
 #    #
 ######
Author: Lee J Haywood and GRIGoRusha
Title: The Rain
