   #####
 ###   #
##     #
# *** ##
# @*  #
# ** ##
###  #
  #  #
  ####
Author: Aymeric du Peloux and GRIGoRusha
Title: Finish
Comment:
date: 15.04.05
For Erim Sever

for play in this level in normal style load NaboKosmos 40a from RemodelClub
Comment-End:
