  #####
###   ##
#@ *#  ##
#.* *   #
#  * *  #
### * $ #
  #  ####
  ####
Author: GRIGoRusha
Title: The lost element
Comment:
date: 22.09.05
Comment-End:
