#####
#   #####
#.#$    #
#.# $$$ #
#.# $ @##
#.# $#$#
#..    #
#.. $# #
####   #
   #####
Author: GRIGoRusha
Title: Unopened Room
