 #####
 # . ###
##$.$$ #
# .+.# #
# $.$  #
# $.$  #
###  ###
  ####
Author: GRIGoRusha
Title: Jesus Cross
Comment:
date: 13.10.05
Comment-End:
