#####
#   ##### 
#       # 
##$#$$$@# 
 # #  ####
## ## $  #
#.... .  #
#   ###  #
##### ####
Author: GRIGoRusha
Title: Gambit
Comment:
date: 02.01.05
Comment-End:
