   ####
####  #
#  *+$##
#  **  #
## * * #
 #   ###
 #   #
 #  ##
 ####
Author: GRIGoRusha
Title: Kosmos
Comment:
date: 24.09.05
Comment-End:
