   #######
 ###@#   #
 # $ $   #
## #$## ##
#   ..* ##
# # .*#$ #
# # #.*  #
#     #  #
##   #####
 #####
Author: GRIGoRusha
Title: MacroCosmos
Comment:
date: 21.07.06
Comment-End:
