#### ####
#  ###  #
#       #
#  ### $##
##$$+*.$ #
## #**.$ #
#   ..#  #
# # #   ##
#   #####
#####
Author: GRIGoRusha
Title: Cosmos
Comment:
date: 14.01.06
Comment-End:
