####
#  ####
#  $  #
#.$+$.#
# .$. #
# $.$ #
# $. ##
######
Author: Dries De Clercq and GRIGoRusha
Title: 
Comment: The Palm
date: 28.06.06
Comment-End:
