 ########
 #   @  ###
## ## #   #
#  ##   $ #
# $##$## ##
# $ .$.$$#
##$..... #
 # .#$#.$#
 # ..$.. #
 ##### $$#
     #   #
     #####
Author: GRIGoRusha
Title: The Temple
Comment:
for Hir
Comment-End:
