 #####     
 # + #     
 #$.$#     
 # * #     
 # * #     
 # * ######
## * $    #
#  * **.*.#
#    $    #
##  #######
 ####      
Author: GRIGoRusha
Title: Duble Hanoy
Comment:
for Aymeric
Comment-End:
