 #####
 #   #  
## # ###
#  $   #
# *** .#
## *   #
 # * ###
 # @##  
 ####   
Author: GRIGoRusha
Title: Flame Cross
Comment:
date: 24.09.05
Comment-End:
