 ####
 #  #####
 #$ $ . #
## * * @#
# . * *##
#  *   # 
#####  # 
    #### 
Author: GRIGoRusha
Title: Star shower
Comment:
date: 19.04.05
Comment-End:
