#####
#   ##
# $. #
##$. #
 # . #
 #$.$###
 #@.$  #
 #$.$. #
 #   ###
 #####
Author: Dries De Clercq and GRIGoRusha
Title: Unfinished Line
Comment:
date: 30.03.05
Comment-End:
