  ####
  #  ###
  #  $ #
###* * #
#  * . #
#   #* #
## * @##
 #  ###
 ####
Author: Dries De Clercq and GRIGoRusha
Title: Unfinished Rain
Comment:
date: 23.03.05
Comment-End:
