   ####
####  ###
#       #
# .*#$  #
##$.* $##
# .*.$ #
#  ## @#
#  ##  #
########
Author: GRIGoRusha
Title: Infinity
Comment:
date: 30.01.08
Comment-End:
