   #####
   #@  #
 ###$# #
 #  $  #
 # .*.###
 #$.*.$ #
 # .*.  #
## #$# ##
#   $   #
#   #   #
#########
Author: GRIGoRusha
Title: Right way
