    ####
#####  ##
#  $@$  #
#  $$$#.#
## # ...#
 # # ...#
## #$# ##
#   $  #
#   ####
#####
Author: GRIGoRusha
Title: The Cup
Comment:
date: 09.01.06
Comment-End:
