  ####
### @#
#  $ ###
#.$.$  #
# .$.  #
#.$#$###
# .  #
#  ###
####
Author: Dries De Clercq and GRIGoRusha
Title: Unfinished Cell
Comment:
date: 29.03.05
Comment-End:
