     ####
    ##  #
#####   #
# $ $ $ #
# ..#  ##
##$.*.$#
 # .*  #
 #$ +###
 #   #
 #####
Author: GRIGoRusha
Title: The Tornado
