  #####
  # @ #
  # # #
###$. ###
#  $.$  #
# .$ $. #
### .$###
  # . #
  #####
Author: Dries De Clercq and GRIGoRusha
Title: Parallel World
Comment:
date: 21.06.06
Comment-End:
