     ####
  ####  #
  #  $  #
  #  $  #
### .## #
# ...## ##
# $$.$ $@#
# .###   #
#### #####
Author: GRIGoRusha
Title: The Bend