######   
#. . ####
#$.#.$  #
#.$.$.$ #
#@.$.$  #
# $   $ #
#####  ##
    #### 
Author: GRIGoRusha
Title: Zvezdopad
Comment:
date: 20.12.07
Comment-End:
