#####
#   ##
# $  #
## $ ####
 ###@.  #
  #  .# #
  #     #
  #######
