       ####
########  #
#@ $ $ $$ ###
#  ....*.*  #
## ### ..*# #
 #$$  # .*  #
 # # $ #.*# #
 #   $ #..  #
 ##  $    ###
  ### #$#.#
   # $ $  #
   #     ##
   #######
