      #####
      #   #
     ## $ ##
    ## $.$ ##
   ## $ * $ ##
  ## $.*.*.$ ##
### $.*.#.*.$ ###
#  $ *.# #.* $  #
# $.*.#   #.*.$ #
#  $ *.# #.* $  #
### $.*.#.*.$ ###
  ## $.*.*.$ ##
   ## $ * $ ##
    ## $.$ ##
     ## $ ##
      # @ #
      #####
