     #######
#### #     #
#  ### $$$ #
#  ....$  #####
#  ..# $  #  @#
###$##$#### # ######
 #.*....$  $  ###  #####
 # ..#####  ##   $ $   #
 #....*.... #  $$  # $ #
 ########## #$$ ## #   #
    # $.###        $  ##
    #       $###$# #  #
    #####   $    $ ####
        ####    ####
           ######
