 #########
##   *   ##
#  # # #  #
# #.$.$.# #
#  $.$.$  #
#*#.$@$.#*#
#  $.$.$  #
# #.$.$.# #
#  # # #  #
##   *   ##
 #########
