########
#  . . #
# $.$. #
##$#$# ##
 # . .  #
 #$#$# @#
 # . .  #
##$#$# ##
#  . . #
# $#$# ###
##   . . #
 ###$#$# #
   # .   #
   #$# ###
   #   #
   #####
