 #### ### ####
#    #   #    #
# #  #   #  # #
#  **$***$**  #
#  * .   . *  #
 ##$.## ##.$##
#  * #   # *  #
#  *   @   *  #
#  * #   # *  #
 ##$.## ##.$##
#  * .   . *  #
#  **$***$**  #
# #  #   #  # #
#    #   #    #
 #### ### ####
