####   #####   ####
#  ##  #   #####  #
# $.#  # $     $  #
#  .#  #   #####  #
## .#### ###  ##$##
 #$. $     #  $   #
 # ..###   #  #   #
 #*..@#######$#####
 # ..####   #  #
 #$. $      #  #
## .######$##  #
#  .#   #  ##$##
# $.#   #  $   #
#  ##   #  #   #
####    ########
