###############################
#  .  .  .  .  .  .  .  .  .  #
# $ $ # $ $ # $ $ # $ $ # $ $ #
###.#####.#####.#####.#####.###
# $ $ # $ $ # $ $ # $ $ # $ $ #
#     .     .   # .     .     #
###.#####.###########.#####.###
#  $  #  $  . *@# #  *  *  $  #
#  $  *  *  # # * .  $  #  $  #
###.#####.###########.#####.###
#     .     . #   .     .     #
# $ $ # $ $ # $ $ # $ $ # $ $ #
###.#####.#####.#####.#####.###
# $ $ # $ $ # $ $ # $ $ # $ $ #
#  .  .  .  .  .  .  .  .  .  #
###############################
