# ####  #  #### #
 #    #   #    #
# *.   ###   .* #
# $# $ $ $ $ #$ #
#   # .* *. #   #
#  . #  $  # .  #
 #  $ ##$## $  #
  #.* # . # *.#
# #  ..$@$..  # #
  #.* # . # *.#
 #  $ ##$## $  #
#  . #  $  # .  #
#   # .* *. #   #
# $# $ $ $ $ #$ #
# *.   ###   .* #
 #    #   #    #
# ####  #  #### #
