         #######
  ########  #. #
  #        $ * #####
  # ## ##   #. #   #      ####
### # $ $$#$#. # # ########  #
#  $#   #  $ * #......       #
# $    ### $#.  #  ####      #
## # #$$ # $ .# #  #  ##     #
 # #   $   @##  # ##   ##   ##
 #  ##  $$$ #  ## ###   #####
 ##  #.##.###       #
  ## #*$.*...  ##   #
   #   #   ##  ##  ##
   ###   ###########
     #####
