            ####
    #####   #  #####
   ##   #   #      #
   #  # ##### # #  #
   # # $ $ $ $ #  ##
   # #       #  # #
   #  ######$## # #
####  # *  #  # # #
#   $ # .. $  # # #
# # # #*...# #  # #
# .***#. ..#   ## ##
##*....*.*  $ #    #
 ##* ##.##### # $  #
  ##  #     $  # # #
   ##@ #.#$ $ $ $# #
    ##    $ $  #   #
     ##  ###########
      ####
