     #####
     #   #
     #   #        ######
   ###  ## #####  #    ###
   #    #        ## #$$  #
  ##$   ########## $  $  #
###  ## ..........$  #$$@#
#    # $$# ####### $     #
#   $  #...#     ###  ####
#   #   $ ### ##   ####
########    #
       #    #
       #    #
       ######
