#####
#@$.#
#$  #####
#      .#
#########

