      ##########
####  #    #.  #
#  #### ## #   ###
#   ..  $  # #  .#
#   ..  # ##   $ #
####### # #@$  .##
      # # ####  #
####### #    # ##
#    $  #### # #
#  # ##      # ###
# ## ##### ###   #
# #    $       # #
# #   # ###### # #
# #####$         #
#   $   ######  ##
#####   #    #####
    #####
Author: Martin Gerhardy
Title: Very Beginning
