;  90 'LOMA 8b'

 ####
 #  ##
## * ##
# .@$ #
#  *  #
#  #  #
#######
