;  76 'LOMA 4d'

 ######
 ###  #
 # . @#
 # $  #
###* ##
#  $ ##
# #. #
#   ##
##  ##
######
