;  91 'LOMA 8c'

  #####
 ##   #
## *  #
# .@$##
#  *  #
###   #
#######
