;  95 'LOMA 9c'

  ####
  #@ #
  #  ##
###$* ##
#  *.  #
#      #
#####  #
    ####
