;  69 'LOMA 3a'

  ####
 ##  #
 # . #
 # * #
## *###
#  $ #
#  @ #
#  ###
####
