;  11 'derived from SokHard 1'

######
# * .#
#.  $#
#.#$.#
#   $##
##@ $ #
 #    #
 ######
