;  44 'based on Pufiban #154'

########### ###########
# $ .##         ##. $ #
# ..$###### ######$.. #
# $$ $ .#     #. $ $$ #
##  ...$#######$...  ##
#### $$ $ .#. $ $$ ####
# ###  ...$#$...  ### #
# # ### $$   $$ ### # #
# # # ##  . .  ## # # #
       ####@####
# # # ##  . .  ## # # #
# # ### $$   $$ ### # #
# ###  ...$#$...  ### #
#### $$ $ .#. $ $$ ####
##  ...$#######$...  ##
# $$ $ .#     #. $ $$ #
# ..$###### ######$.. #
# $ .##         ##. $ #
########### ###########
