;  12 'derived from SokHard 5'

    #####
##### @ #
#  $  $ #
#  ****.#
#  . #  #
#  ### ##
##     #
 #######
