########
#  #   #
#  .** #
#   *  #
## *** #
 #  *  #
 ###$ ##
   #@ #
   ####
Author: GRIGoRusha
Title: Comet tail
Comment:
date: 11.06.05
Comment-End:
