  ####
 ## .#####
##  $  @ #
#  #$# $ #
#....# ###
# $ $ $#
##  ## #
 #  .  #
 #######
Author: GRIGoRusha
Title: Travel Art
Comment:
date: 09.07.06
Comment-End:
