   #####
 ###   ##
 # ...  #
## *.*# #
#  #*.$ #
#  $ $ ##
# $ @#$#
## ### #
 #     #
 #######
Author: GRIGoRusha
Title: Kenya House
