#####
#   ######
# $      #
##$# $$$ #
#  ## $ ##
# $  .#.##
#  #..*.@#
##   .*. #
 #########
Author: GRIGoRusha
Title: Tabu
Comment:
date: 10.01.06
Comment-End:
