 ####    
 #  #####
 # .... #
 #$.# . #
 # .#$.##
##$# $  #
# @  $  #
# $$$ ###
#    ##  
######   
Author: GRIGoRusha
Title: Choise-Point