  ####
###  #
#    ##
# * * #
# .*  ##
#**#*$@#
#      #
#  #####
####
Author: GRIGoRusha
Title: Firework
Comment:
date: 09.07.06
Comment-End:
