      #####
#######   #
#   ##  $ #
# .... # ##
## #$ #@$#
 #  .*** ##
 ##$# # $ #
  #       #
  ##   ####
   #####
Author: GRIGoRusha
Title: Tamerlan
Comment:
date: 12.01.06
Comment-End:
