 ####
 #  #
 #  #####
 #  $ $ #
 #$.*.@ #
## .*.$ #
#  #$# ##
#  .$. #
#  #####
####
Author: GRIGoRusha
Title: Big Boss
