     ######
   ### * @#
  ##  * $ #
###  * #  #
#   . *  ##
# #***##  #
#   *     #
########  #
       ####
Author: GRIGoRusha
Title: JigSaw
Comment:
date: 01.07.06
old name - GrigrStar 20
Comment-End: