    #####
#####   #
#     # #
# $$#*. #
##$@.* ##
#  $*. #
#   #.##
###   #
  #####
Author: GRIGoRusha
Title: Flower
Comment:
date: 18.10.05
Comment-End:
