   ####
   #  #
####$ ###
#  $ $  #
#@$...# #
## #.$  #
 # *.*  #
 #  #####
 #  #
 ####
Author: GRIGoRusha
Title: My House
