  ####
  #  ###
### .  #
#   *  #
# $@**##
### *  #
  # *  #
  # *  #
  ######
Author: GRIGoRusha
Title: Fakel
Comment:
date: 09.01.06
Comment-End:
