  ####
  #  ##
 ## * #
 #  * ##
## #@  #
# *** .#
#   $ ##
###   #
  #####
Author: Dries De Clercq and GRIGoRusha
Title: Broken angle
Comment:
date: 23.06.06
Comment-End:
