     ####
######  ##
# $  $$  #
# ...  # #
##$ ##   #
 #...$$$##
 #.# $   #
 #.  # @ #
 #########
Author: GRIGoRusha
Title: Many Angles
Comment:
date: 31.07.06
Comment-End:
