  ####
  #  #
 ##  ####
 # **   #
##  *@# #
#   *** #
#     ###
#######
Author: Dries De Clercq and GRIGoRusha
Title: Train
Comment:
date: 19.06.06
Comment-End:


