 ######
 # @  ##
 #$*** #
## *   #
#  *  ##
# #*  #
#  . *#
###   #
  #####
Author: GRIGoRusha
Title: Landing
Comment:
date: 07.10.05
Comment-End:
