    ####
 ####  #
 #  #$ #
 #   $.#
 #  #$.#
###$. .#
#  $.# #
# #$.  #
#  @####
#####
Author: GRIGoRusha
Title: Overturn
Comment:
date: 24.01.08
Comment-End:
