   #####
 ###   ##
 # .*.  #
## $+$  #
#  *** ##
# $ . $ #
#####   #
    #####
Author: GRIGoRusha
Title: Artificial satellite
Comment:
date: 21.09.05
Comment-End:
