;  89 'LOMA 8a'

  #####
 ##   #
###   #
#  * ##
# .@$##
#  * ##
##  ##
#####
