;  88 'LOMA 7d'

  ####
  #  #####
  #      #
### ###  #
# @$  #  #
# $*. # ##
###.### #
 #      #
 #   #  #
 ########
