;  62 'LOMA 1c'

 #####
 #   ####
 #  $.  #
 ## $.  #
  ##$.###
   #@ #
   ####
