;  96 'LOMA 9d'

     ####
######  #
#  ##   #
#   $*  #
#  #*. ##
##  @ ##
 #  ###
 ####
