;  77 'LOMA 5a'

 ####
 #  #
 #  #
 #  ####
###$$  #
#  $.  #
# #..###
# @# #
##   #
######
