;  75 'LOMA 4c'

#####
#   #
# . #
# $ #
##* ##
# $  #
# . @#
###  #
  ####
