;  68 'LOMA 2d'

   #####
####   #
#  $.# #
#@#.$  #
# #$.###
# #  #
#    #
######
