;  72 'LOMA 3d'

 ######
 # .  #
 # *# #
 #@*  #
 # * ##
 ##$  #
 #    #
 # # ##
 #   #
 #####
