;  71 'LOMA 3c'

 #####
 # . #
 # * #
## * #
#  * #
# @$ #
#  ###
####
