;  98 'LOMA 10b'

####
#  #
#@ ###
# $$ ##
# $ . #
###.. #
 #   ##
 #   #
 #####
