;  99 'LOMA 10c'

######
#    #
#    #
## $$##
 # $@.#
 ## ..#
  #####
