;  80 'LOMA 5d'

 #####
 #   #
 # # #
 # @ #
##$$###
# $.  #
# ..# #
###   #
  #####
