;  60 'LOMA 1a'

  #####
 ##   ##
### #  #
###$.# #
#  $.#@#
# #$.# #
# #    #
#  # ###
##   ##
 #####
