;  64 'LOMA 1e'

##### ####
#   ###  #
#    ##@ #
##    #$.#
 ##    $.#
# ##  #$.#
## ## #  #
### ######
