;  46 'original level #29 simplified'

 ############
 #   #      #
 # #  $$#$# ##
 # #         #
 # ### ##### #
 # @# .... # #
##  # .... # ##
#  ######$##  #
#  $  $    $$ #
####   #   #  #
   ############
