;  82 'LOMA 6b'

  ####
 ##  #
###$ #
# .*.#
# #$ #
#  @ #
#   ##
#####
