;  100 'LOMA 10d'

  #####
###   #
# $$# #
# $@. #
#  .. #
#######
